111111111111111111111111111111
1P0000000000000000000000000001
100000001111110000001111100001
100000000000000000000000100001
100000001111111110011000000001
100000001C00000000001000000001
100000001111111111111000001111
100000000000000000000000000001
10000000000000001111000000000E
111111111111111111111111111111