111111111111111111111111111111
1P0000001000000000000000000001
100000001111110000001111100001
100000000000000000000000100001
100000001110000100000111000001
100000000000000000000000000001
100000001111111111111000001111
100000000000000000000000000001
100000000000000011110000000001
111111111111111111111111111111