111111111111111111111111111111
2P0000000000000000000000000003
200000000000000000000000000003
200000000000000000000000100003
200000000000000000000000000003
200000000000000000000000000003
200000000000000000000000000003
200000000000000000000000000003
20000000000000000000000000000E
244444444444444444444444444443